all walks of life|各行各业
anticipate|预期、期待
approached|接近、靠近
bent|弯曲、倾向
above all|最重要的是
catch|抓住、理解
content|内容；满足的
copy|复制、拷贝
course|课程、过程
download|下载
ease|容易、缓解
engage|参与、吸引
enveloped|包围、笼罩
extraordinary|非凡的、特别的
faded|褪色、消退
fulfillment|满足、实现
highly informed|非常了解的
humbled|感到谦卑的
humbling|令人感到谦卑的
imagine|想象
landscape|风景、地形
lectured|演讲、训诫
local|当地的、本地的；本地人
long for|渴望、向往
long-lost|失散已久的
negotiate|谈判、协商
obvious|明显的
open mind|开放的心态
optimistic|乐观的
overjoyed|欣喜若狂的
persistence|坚持、毅力
publish|出版、发布
quote|引用、引述
recall|回忆、召回
reflect|反映、反思
remarkable|非凡的、显著的
satisfied|满意的
side|侧面、一边
so-called|所谓的
spotted|发现的、斑点的
support|支持
thirst|渴望、渴求
towering|高耸的
treated|对待、治疗
unlike|不像、与...不同
valleys|山谷
virtually|几乎、实际上
willingness|意愿、愿望
witnessed|见证、目睹